电影名:肖申克的救赎	导演: 弗兰克·德拉邦特 Frank Darabont&nbsp;&nbsp;&nbsp;主演: 蒂姆·罗宾斯 Tim Robbins /...		简介:希望让人自由。
电影名:霸王别姬	导演: 陈凯歌 Kaige Chen&nbsp;&nbsp;&nbsp;主演: 张国荣 Leslie Cheung / 张丰毅 Fengyi Zha...		简介:风华绝代。
电影名:这个杀手不太冷	导演: 吕克·贝松 Luc Besson&nbsp;&nbsp;&nbsp;主演: 让·雷诺 Jean Reno / 娜塔莉·波特曼 ...		简介:怪蜀黍和小萝莉不得不说的故事。
电影名:阿甘正传	导演: Robert Zemeckis&nbsp;&nbsp;&nbsp;主演: Tom Hanks / Robin Wright Penn / Gary Sinise		简介:一部美国近现代史。
电影名:美丽人生	导演: 罗伯托·贝尼尼 Roberto Benigni&nbsp;&nbsp;&nbsp;主演: 罗伯托·贝尼尼 Roberto Beni...		简介:最美的谎言。
电影名:泰坦尼克号	导演: 詹姆斯·卡梅隆 James Cameron&nbsp;&nbsp;&nbsp;主演: 莱昂纳多·迪卡普里奥 Leonardo...		简介:失去的才是永恒的。 
电影名:千与千寻	导演: 宫崎骏 Hayao Miyazaki&nbsp;&nbsp;&nbsp;主演: 柊瑠美 Rumi Hîragi / 入野自由 Miy...		简介:最好的宫崎骏，最好的久石让。 
电影名:辛德勒的名单	导演: 史蒂文·斯皮尔伯格 Steven Spielberg&nbsp;&nbsp;&nbsp;主演: 连姆·尼森 Liam Neeson...		简介:拯救一个人，就是拯救整个世界。
电影名:盗梦空间	导演: 克里斯托弗·诺兰 Christopher Nolan&nbsp;&nbsp;&nbsp;主演: 莱昂纳多·迪卡普里奥 Le...		简介:诺兰给了我们一场无法盗取的梦。
电影名:机器人总动员	导演: 安德鲁·斯坦顿 Andrew Stanton&nbsp;&nbsp;&nbsp;主演: 本·贝尔特 Ben Burtt / 艾丽...		简介:小瓦力，大人生。
电影名:忠犬八公的故事	导演: 莱塞·霍尔斯道姆 Lasse Hallström&nbsp;&nbsp;&nbsp;主演: 理查·基尔 Richard Ger...		简介:永远都不能忘记你所爱的人。
电影名:三傻大闹宝莱坞	导演: 拉库马·希拉尼 Rajkumar Hirani&nbsp;&nbsp;&nbsp;主演: 阿米尔·汗 Aamir Khan / 卡...		简介:英俊版憨豆，高情商版谢耳朵。
电影名:海上钢琴师	导演: 朱塞佩·托纳多雷 Giuseppe Tornatore&nbsp;&nbsp;&nbsp;主演: 蒂姆·罗斯 Tim Roth / ...		简介:每个人都要走一条自己坚定了的路，就算是粉身碎骨。 
电影名:放牛班的春天	导演: 克里斯托夫·巴拉蒂 Christophe Barratier&nbsp;&nbsp;&nbsp;主演: 杰拉尔·朱诺 Géra...		简介:天籁一般的童声，是最接近上帝的存在。 
电影名:大话西游之大圣娶亲	导演: 刘镇伟 Jeffrey Lau&nbsp;&nbsp;&nbsp;主演: 周星驰 Stephen Chow / 吴孟达 Man Tat Ng...		简介:一生所爱。
电影名:楚门的世界	导演: 彼得·威尔 Peter Weir&nbsp;&nbsp;&nbsp;主演: 金·凯瑞 Jim Carrey / 劳拉·琳妮 Lau...		简介:如果再也不能见到你，祝你早安，午安，晚安。
电影名:教父	导演: 弗朗西斯·福特·科波拉 Francis Ford Coppola&nbsp;&nbsp;&nbsp;主演: 马龙·白兰度 M...		简介:千万不要记恨你的对手，这样会让你失去理智。
电影名:龙猫	导演: 宫崎骏 Hayao Miyazaki&nbsp;&nbsp;&nbsp;主演: 日高法子 Noriko Hidaka / 坂本千夏 Ch...		简介:人人心中都有个龙猫，童年就永远不会消失。
电影名:星际穿越	导演: 克里斯托弗·诺兰 Christopher Nolan&nbsp;&nbsp;&nbsp;主演: 马修·麦康纳 Matthew Mc...		简介:爱是一种力量，让我们超越时空感知它的存在。
电影名:熔炉	导演: 黄东赫 Dong-hyuk Hwang&nbsp;&nbsp;&nbsp;主演: 孔侑 Yoo Gong / 郑有美 Yu-mi Jeong ...		简介:我们一路奋战不是为了改变世界，而是为了不让世界改变我们。
电影名:无间道	导演: 刘伟强 / 麦兆辉&nbsp;&nbsp;&nbsp;主演: 刘德华 / 梁朝伟 / 黄秋生		简介:香港电影史上永不过时的杰作。
电影名:触不可及	导演: 奥利维·那卡什 Olivier Nakache / 艾力克·托兰达 Eric Toledano&nbsp;&nbsp;&nbsp;主...		简介:满满温情的高雅喜剧。
电影名:当幸福来敲门	导演: 加布里尔·穆奇诺 Gabriele Muccino&nbsp;&nbsp;&nbsp;主演: 威尔·史密斯 Will Smith ...		简介:平民励志片。 
电影名:乱世佳人	导演: 维克多·弗莱明 Victor Fleming / 乔治·库克 George Cukor&nbsp;&nbsp;&nbsp;主演: 费...		简介:Tomorrow is another day.
电影名:怦然心动	导演: 罗伯·莱纳 Rob Reiner&nbsp;&nbsp;&nbsp;主演: 玛德琳·卡罗尔 Madeline Carroll / 卡...		简介:真正的幸福是来自内心深处。
电影名:疯狂动物城	导演: 拜伦·霍华德 Byron Howard / 瑞奇·摩尔 Rich Moore&nbsp;&nbsp;&nbsp;主演: 金妮弗·...		简介:迪士尼给我们营造的乌托邦就是这样，永远善良勇敢，永远出乎意料。
电影名:天堂电影院	导演: 朱塞佩·托纳多雷 Giuseppe Tornatore&nbsp;&nbsp;&nbsp;主演: 安东娜拉·塔莉 Antonel...		简介:那些吻戏，那些青春，都在影院的黑暗里被泪水冲刷得无比清晰。
电影名:蝙蝠侠：黑暗骑士	导演: 克里斯托弗·诺兰 Christopher Nolan&nbsp;&nbsp;&nbsp;主演: 克里斯蒂安·贝尔 Christ...		简介:无尽的黑暗。
电影名:活着	导演: 张艺谋 Yimou Zhang&nbsp;&nbsp;&nbsp;主演: 葛优 You Ge / 巩俐 Li Gong / 姜武 Wu Jiang		简介:张艺谋最好的电影。
电影名:十二怒汉	导演: Sidney Lumet&nbsp;&nbsp;&nbsp;主演: 亨利·方达 Henry Fonda / 马丁·鲍尔萨姆 Marti...		简介:1957年的理想主义。 
电影名:少年派的奇幻漂流	导演: 李安 Ang Lee&nbsp;&nbsp;&nbsp;主演: 苏拉·沙玛 Suraj Sharma / 伊尔凡·可汗 Irrfan...		简介:瑰丽壮观、无人能及的冒险之旅。
电影名:鬼子来了	导演: 姜文 Wen Jiang&nbsp;&nbsp;&nbsp;主演: 姜文 Wen Jiang / 香川照之 Teruyuki Kagawa /...		简介:对敌人的仁慈，就是对自己残忍。
电影名:指环王3：王者无敌	导演: 彼得·杰克逊 Peter Jackson&nbsp;&nbsp;&nbsp;主演: 维果·莫腾森 Viggo Mortensen / ...		简介:史诗的终章。
电影名:搏击俱乐部	导演: 大卫·芬奇 David Fincher&nbsp;&nbsp;&nbsp;主演: 爱德华·诺顿 Edward Norton / 布拉...		简介:邪恶与平庸蛰伏于同一个母体，在特定的时间互相对峙。
电影名:天空之城	导演: 宫崎骏 Hayao Miyazaki&nbsp;&nbsp;&nbsp;主演: 田中真弓 Mayumi Tanaka / 横泽启子 Ke...		简介:对天空的追逐，永不停止。 
电影名:控方证人	导演: 比利·怀尔德 Billy Wilder&nbsp;&nbsp;&nbsp;主演: 查尔斯·劳顿 Charles Laughton / ...		简介:比利·怀德满分作品。
电影名:飞屋环游记	导演: 彼特·道格特 Pete Docter / 鲍勃·彼德森 Bob Peterson&nbsp;&nbsp;&nbsp;主演: 爱德...		简介:最后那些最无聊的事情，才是最值得怀念的。 
电影名:大话西游之月光宝盒	导演: 刘镇伟 Jeffrey Lau&nbsp;&nbsp;&nbsp;主演: 周星驰 Stephen Chow / 吴孟达 Man Tat Ng...		简介:旷古烁今。
电影名:罗马假日	导演: 威廉·惠勒 William Wyler&nbsp;&nbsp;&nbsp;主演: 奥黛丽·赫本 Audrey Hepburn / 格...		简介:爱情哪怕只有一天。
电影名:窃听风暴	导演: 弗洛里安·亨克尔·冯·多纳斯马 Florian Henckel von Donnersmarck&nbsp;&nbsp;&nbsp;...		简介:别样人生。
电影名:摔跤吧！爸爸	导演: 涅提·蒂瓦里 Nitesh Tiwari&nbsp;&nbsp;&nbsp;主演: 阿米尔·汗 Aamir Khan / 法缇玛...		简介:你不是在为你一个人战斗，你要让千千万万的女性看到女生并不是只能相夫教子。
电影名:两杆大烟枪	导演: Guy Ritchie&nbsp;&nbsp;&nbsp;主演: Jason Flemyng / Dexter Fletcher / Nick Moran		简介:4个臭皮匠顶个诸葛亮，盖·里奇果然不是盖的。
电影名:辩护人	导演: 杨宇硕 Woo-seok Yang&nbsp;&nbsp;&nbsp;主演: 宋康昊 Kang-ho Song / 吴达洙 Dal-su O...		简介:电影的现实意义大过电影本身。
电影名:闻香识女人	导演: 马丁·布莱斯 Martin Brest&nbsp;&nbsp;&nbsp;主演: 阿尔·帕西诺 Al Pacino / 克里斯...		简介:史上最美的探戈。
电影名:飞越疯人院	导演: 米洛斯·福尔曼 Miloš Forman&nbsp;&nbsp;&nbsp;主演: 杰克·尼科尔森 Jack Nichols...		简介:自由万岁。
电影名:哈尔的移动城堡	导演: 宫崎骏 Hayao Miyazaki&nbsp;&nbsp;&nbsp;主演: 倍赏千惠子 Chieko Baishô / 木村拓...		简介:带着心爱的人在天空飞翔。
电影名:死亡诗社	导演: 彼得·威尔 Peter Weir&nbsp;&nbsp;&nbsp;主演: 罗宾·威廉姆斯 Robin Williams / 罗伯...		简介:当一个死水般的体制内出现一个活跃的变数时，所有的腐臭都站在了光明的对面。
电影名:V字仇杀队	导演: 詹姆斯·麦克特格 James McTeigue&nbsp;&nbsp;&nbsp;主演: 娜塔莉·波特曼 Natalie Por...		简介:一张面具背后的理想与革命。
电影名:海豚湾	导演: Louie Psihoyos&nbsp;&nbsp;&nbsp;主演: John Chisholm / Mandy-Rae Cruikshank / Char...		简介:海豚的微笑，是世界上最高明的伪装。
电影名:教父2	导演: 弗朗西斯·福特·科波拉 Francis Ford Coppola&nbsp;&nbsp;&nbsp;主演: 阿尔·帕西诺 A...		简介:优雅的孤独。
电影名:指环王2：双塔奇兵	导演: 彼得·杰克逊 Peter Jackson&nbsp;&nbsp;&nbsp;主演: 伊利亚·伍德 Elijah Wood / 西恩...		简介:承前启后的史诗篇章。
电影名:指环王1：魔戒再现	导演: 彼得·杰克逊 Peter Jackson&nbsp;&nbsp;&nbsp;主演: 伊利亚·伍德 Elijah Wood / 西恩...		简介:传说的开始。
电影名:美丽心灵	导演: 朗·霍华德 Ron Howard&nbsp;&nbsp;&nbsp;主演: 罗素·克劳 Russell Crowe / 艾德·哈...		简介:爱是一切逻辑和原由。
电影名:饮食男女	导演: 李安 Ang Lee&nbsp;&nbsp;&nbsp;主演: 郎雄 Sihung Lung / 杨贵媚 Kuei-Mei Yang / 吴...		简介:人生不能像做菜，把所有的料都准备好了才下锅。
电影名:情书	导演: 岩井俊二 Shunji Iwai&nbsp;&nbsp;&nbsp;主演: 中山美穗 Miho Nakayama / 丰川悦司 Ets...		简介:暗恋的极致。
电影名:素媛	导演: 李濬益 Jun-ik Lee&nbsp;&nbsp;&nbsp;主演: 薛景求 Kyung-gu Sol / 严志媛 Ji-won Uhm ...		简介:受过伤害的人总是笑得最开心，因为他们不愿意让身边的人承受一样的痛苦。
电影名:狮子王	导演: Roger Allers / 罗伯·明可夫 Rob Minkoff&nbsp;&nbsp;&nbsp;主演: 乔纳森·泰勒·托马...		简介:动物版《哈姆雷特》。
电影名:美国往事	导演: 赛尔乔·莱翁内 Sergio Leone&nbsp;&nbsp;&nbsp;主演: 罗伯特·德尼罗 Robert De Niro ...		简介:往事如烟，无处祭奠。
电影名:钢琴家	导演: 罗曼·波兰斯基 Roman Polanski&nbsp;&nbsp;&nbsp;主演: 艾德里安·布洛迪 Adrien Brod...		简介:音乐能化解仇恨。
电影名:小鞋子	导演: 马基德·马基迪 Majid Majidi&nbsp;&nbsp;&nbsp;主演: Amir Farrokh Hashemian / 默罕...		简介:奔跑的孩子是天使。
电影名:七宗罪	导演: 大卫·芬奇 David Fincher&nbsp;&nbsp;&nbsp;主演: 摩根·弗里曼 Morgan Freeman / 布...		简介:警察抓小偷，老鼠玩死猫。
电影名:被嫌弃的松子的一生	导演: 中岛哲也 Tetsuya Nakashima&nbsp;&nbsp;&nbsp;主演: 中谷美纪 Miki Nakatani / 瑛太 E...		简介:以戏谑来戏谑戏谑。
电影名:致命魔术	导演: 克里斯托弗·诺兰 Christopher Nolan&nbsp;&nbsp;&nbsp;主演: 休·杰克曼 Hugh Jackman...		简介:孪生蝙蝠侠大战克隆金刚狼。
电影名:天使爱美丽	导演: 让-皮埃尔·热内 Jean-Pierre Jeunet&nbsp;&nbsp;&nbsp;主演: 奥黛丽·塔图 Audrey Tau...		简介:法式小清新。 
电影名:本杰明·巴顿奇事	导演: 大卫·芬奇 David Fincher&nbsp;&nbsp;&nbsp;主演: 凯特·布兰切特 Cate Blanchett / ...		简介:在时间之河里感受溺水之苦。
电影名:西西里的美丽传说	导演: 朱塞佩·托纳多雷 Giuseppe Tornatore&nbsp;&nbsp;&nbsp;主演: 莫妮卡·贝鲁奇 Monica ...		简介:美丽无罪。
电影名:黑客帝国	导演: 安迪·沃卓斯基 Andy Wachowski / 拉娜·沃卓斯基 Lana Wachowski&nbsp;&nbsp;&nbsp;主...		简介:视觉革命。
电影名:让子弹飞	导演: 姜文 Wen Jiang&nbsp;&nbsp;&nbsp;主演: 姜文 Wen Jiang / 葛优 You Ge / 周润发 Yun-F...		简介:你给我翻译翻译，神马叫做TMD的惊喜。
电影名:拯救大兵瑞恩	导演: 史蒂文·斯皮尔伯格 Steven Spielberg&nbsp;&nbsp;&nbsp;主演: 汤姆·汉克斯 Tom Hanks...		简介:美利坚精神输出大片No1.
电影名:音乐之声	导演: Robert Wise&nbsp;&nbsp;&nbsp;主演: 朱丽·安德鲁斯 Julie Andrews / 克里斯托弗·普...		简介:用音乐化解仇恨，让歌声串起美好。
电影名:看不见的客人	导演: 奥里奥尔·保罗 Oriol Paulo&nbsp;&nbsp;&nbsp;主演: 马里奥·卡萨斯 Mario Casas / 阿...		简介:你以为你以为的就是你以为的。
电影名:末代皇帝	导演: 贝纳尔多·贝托鲁奇 Bernardo Bertolucci&nbsp;&nbsp;&nbsp;主演: 尊龙 John Lone / 陈...		简介:“不要跟我比惨，我比你更惨”再适合这部电影不过了。
电影名:低俗小说	导演: 昆汀·塔伦蒂诺 Quentin Tarantino&nbsp;&nbsp;&nbsp;主演: 约翰·特拉沃尔塔 John Tra...		简介:故事的高级讲法。
电影名:勇敢的心	导演: 梅尔·吉布森 Mel Gibson&nbsp;&nbsp;&nbsp;主演: 梅尔·吉布森 Mel Gibson / 苏菲·玛...		简介:史诗大片的典范。
电影名:剪刀手爱德华	导演: Tim Burton&nbsp;&nbsp;&nbsp;主演: 约翰尼·德普 Johnny Depp / 薇诺娜·瑞德 Winona ...		简介:浪漫忧郁的成人童话。
电影名:沉默的羔羊	导演: 乔纳森·戴米 Jonathan Demme&nbsp;&nbsp;&nbsp;主演: 朱迪·福斯特 Jodie Foster / 安...		简介:安东尼·霍普金斯的顶级表演。
电影名:大闹天宫	导演: 万籁鸣 Laiming Wan / 唐澄 Cheng  Tang&nbsp;&nbsp;&nbsp;主演: 邱岳峰 Yuefeng Qiu /...		简介:经典之作，历久弥新。
电影名:蝴蝶效应	导演: 埃里克·布雷斯 Eric Bress / J·麦基·格鲁伯 J. Mackye Gruber&nbsp;&nbsp;&nbsp;主...		简介:人的命运被自己瞬间的抉择改变。
电影名:春光乍泄	导演: 王家卫 Kar Wai Wong&nbsp;&nbsp;&nbsp;主演: 张国荣 Leslie Cheung / 梁朝伟 Tony Leu...		简介:爱情纠缠，男女一致。
电影名:入殓师	导演: 泷田洋二郎 Yôjirô Takita&nbsp;&nbsp;&nbsp;主演: 本木雅弘 Masahiro Motoki / ...		简介:死可能是一道门，逝去并不是终结，而是超越，走向下一程。
电影名:心灵捕手	导演: 格斯·范·桑特 Gus Van Sant&nbsp;&nbsp;&nbsp;主演: 马特·达蒙 Matt Damon / 罗宾·...		简介:人生中应该拥有这样的一段豁然开朗。
电影名:哈利·波特与魔法石	导演: Chris Columbus&nbsp;&nbsp;&nbsp;主演: Daniel Radcliffe / Emma Watson / Rupert Grint		简介:童话世界的开端。
电影名:玛丽和马克思	导演: 亚当·艾略特 Adam Elliot&nbsp;&nbsp;&nbsp;主演: 托妮·科莱特 Toni Collette / 菲利...		简介:你是我最好的朋友，你是我唯一的朋友 。
电影名:布达佩斯大饭店	导演: 韦斯·安德森 Wes Anderson&nbsp;&nbsp;&nbsp;主演: 拉尔夫·费因斯 Ralph Fiennes / ...		简介:小清新的故事里注入了大历史的情怀。
电影名:阳光灿烂的日子	导演: 姜文 Wen Jiang&nbsp;&nbsp;&nbsp;主演: 夏雨 Yu Xia / 宁静 Jing Ning / 陶虹 Hong Tao		简介:一场华丽的意淫。
电影名:禁闭岛	导演: Martin Scorsese&nbsp;&nbsp;&nbsp;主演: 莱昂纳多·迪卡普里奥 Leonardo DiCaprio / ...		简介:昔日翩翩少年，今日大腹便便。
电影名:猫鼠游戏	导演: 史蒂文·斯皮尔伯格 Steven Spielberg&nbsp;&nbsp;&nbsp;主演: 莱昂纳多·迪卡普里奥 L...		简介:骗子大师和执著警探的你追我跑故事。 
电影名:幽灵公主	导演: 宫崎骏 Hayao Miyazaki&nbsp;&nbsp;&nbsp;主演: 松田洋治 Yôji Matsuda / 石田百合...		简介:人与自然的战争史诗。
电影名:第六感	导演: M·奈特·沙马兰 M. Night Shyamalan&nbsp;&nbsp;&nbsp;主演: 布鲁斯·威利斯 Bruce Wi...		简介:深入内心的恐怖，出人意料的结局。
电影名:重庆森林	导演: 王家卫 Kar Wai Wong&nbsp;&nbsp;&nbsp;主演: 林青霞 Brigitte Lin / 金城武 Takeshi K...		简介:寂寞没有期限。
电影名:狩猎	导演: 托马斯·温特伯格 Thomas Vinterberg&nbsp;&nbsp;&nbsp;主演: 麦斯·米科尔森 Mads Mik...		简介:人言可畏。
电影名:致命ID	导演: James Mangold&nbsp;&nbsp;&nbsp;主演: John Cusack / Ray Liotta / Amanda Peet		简介:最不可能的那个人永远是最可能的。
电影名:断背山	导演: 李安 Ang Lee&nbsp;&nbsp;&nbsp;主演: 希斯·莱杰 Heath Ledger / 杰克·吉伦哈尔 Jake...		简介:每个人心中都有一座断背山。
电影名:穿条纹睡衣的男孩	导演: 马克·赫门 Mark Herman&nbsp;&nbsp;&nbsp;主演: 阿沙·巴特菲尔德 Asa Butterfield / ...		简介:尽管有些不切实际的幻想，这部电影依旧是一部感人肺腑的佳作。
电影名:大鱼	导演: 蒂姆·波顿 Tim Burton&nbsp;&nbsp;&nbsp;主演: 伊万·麦克格雷格 Ewan McGregor / 阿...		简介:抱着梦想而活着的人是幸福的，怀抱梦想而死去的人是不朽的。
电影名:加勒比海盗	导演: 戈尔·维宾斯基 Gore Verbinski&nbsp;&nbsp;&nbsp;主演: 约翰尼·德普 Johnny Depp / ...		简介:约翰尼·德普的独角戏。
电影名:阿凡达	导演: 詹姆斯·卡梅隆 James Cameron&nbsp;&nbsp;&nbsp;主演: 萨姆·沃辛顿 Sam Worthington ...		简介:绝对意义上的美轮美奂。
电影名:告白	导演: 中岛哲也 Tetsuya Nakashima&nbsp;&nbsp;&nbsp;主演: 松隆子 Takako Matsu / 冈田将生 ...		简介:没有一人完全善，也没有一人完全恶。
电影名:摩登时代	导演: 查理·卓别林 Charles Chaplin&nbsp;&nbsp;&nbsp;主演: 查理·卓别林 Charles Chaplin ...		简介:大时代中的人生，小人物的悲喜。
电影名:一一	导演: 杨德昌 Edward Yang&nbsp;&nbsp;&nbsp;主演: 吴念真 / 李凯莉 Kelly Lee / 金燕玲 Elai...		简介:我们都曾经是一一。
电影名:甜蜜蜜	导演: 陈可辛 Peter Chan&nbsp;&nbsp;&nbsp;主演: 黎明 Leon Lai / 张曼玉 Maggie Cheung / ...		简介:相逢只要一瞬间，等待却像是一辈子。
电影名:射雕英雄传之东成西就	导演: 刘镇伟 Jeffrey Lau&nbsp;&nbsp;&nbsp;主演: 梁朝伟 Tony Leung Chiu Wai / 林青霞 Bri...		简介:百看不厌。 
电影名:阳光姐妹淘	导演: 姜炯哲 Hyeong-Cheol Kang&nbsp;&nbsp;&nbsp;主演: 沈恩京 Eun-kyung Shim / 闵孝琳 Hy...		简介:再多各自牛逼的时光，也比不上一起傻逼的岁月。 
电影名:消失的爱人	导演: 大卫·芬奇 David Fincher&nbsp;&nbsp;&nbsp;主演: 本·阿弗莱克 Ben Affleck / 罗莎蒙...		简介:年度最佳date movie。
电影名:爱在黎明破晓前	导演: 理查德·林克莱特 Richard Linklater&nbsp;&nbsp;&nbsp;主演: 伊桑·霍克 Ethan Hawke ...		简介:缘分是个连绵词，最美不过一瞬。
电影名:上帝之城	导演: Kátia Lund / Fernando Meirelles&nbsp;&nbsp;&nbsp;主演: Alexandre Rodrigues / Lea...		简介:被上帝抛弃了的上帝之城。
电影名:侧耳倾听	导演: 近藤喜文 Yoshifumi Kondo&nbsp;&nbsp;&nbsp;主演: 本名阳子 Youko Honna / 小林桂树 K...		简介:少女情怀总是诗。
电影名:爱在日落黄昏时	导演: 理查德·林克莱特 Richard Linklater&nbsp;&nbsp;&nbsp;主演: 伊桑·霍克 Ethan Hawke ...		简介:九年后的重逢是世俗和责任的交叠，没了悸动和青涩，沧桑而温暖。
电影名:风之谷	导演: 宫崎骏 Hayao Miyazaki&nbsp;&nbsp;&nbsp;主演: 岛本须美 Sumi Shimamoto / 松田洋治 Y...		简介:动画片的圣经。
电影名:超脱	导演: 托尼·凯耶 Tony Kaye&nbsp;&nbsp;&nbsp;主演: 艾德里安·布洛迪 Adrien Brody / 马西...		简介:穷尽一生，我们要学会的，不过是彼此拥抱。
电影名:小森林 夏秋篇	导演: 森淳一 Junichi Mori&nbsp;&nbsp;&nbsp;主演: 桥本爱 Ai Hashimoto / 三浦贵大 Takahir...		简介:那些静得只能听见呼吸的日子里，你明白孤独即生活。
电影名:喜剧之王	导演: 周星驰 Stephen Chow / 李力持 Lik-Chi Lee&nbsp;&nbsp;&nbsp;主演: 周星驰 Stephen Ch...		简介:我是一个演员。
电影名:倩女幽魂	导演: 程小东 Siu-Tung Ching&nbsp;&nbsp;&nbsp;主演: 张国荣 Leslie Cheung / 王祖贤 Joey W...		简介:两张绝世的脸。 
电影名:恐怖直播	导演: 金秉祐 Byeong-woo Kim&nbsp;&nbsp;&nbsp;主演: 河正宇 Jung-woo Ha / 李璟荣 Kyeong-y...		简介:恐怖分子的“秋菊打官司”。
电影名:红辣椒	导演: 今敏 Satoshi Kon&nbsp;&nbsp;&nbsp;主演: 林原惠美 Megumi Hayashibara / 古谷彻 T...		简介:梦的勾结。
电影名:菊次郎的夏天	导演: 北野武 Takeshi Kitano&nbsp;&nbsp;&nbsp;主演: 北野武 Takeshi Kitano / 关口雄介 Yus...		简介:从没见过那么流氓的温柔，从没见过那么温柔的流氓。
电影名:驯龙高手	导演: 迪恩·德布洛斯 Dean DeBlois / 克里斯·桑德斯 Chris Sanders&nbsp;&nbsp;&nbsp;主演:...		简介:和谐的生活离不开摸头与被摸头。
电影名:幸福终点站	导演: 史蒂文·斯皮尔伯格 Steven Spielberg&nbsp;&nbsp;&nbsp;主演: 汤姆·汉克斯 Tom Hanks...		简介:有时候幸福需要等一等。 
电影名:神偷奶爸	导演: 皮艾尔·柯芬 Pierre Coffin / 克里斯·雷纳德 Chris Renaud&nbsp;&nbsp;&nbsp;主演: ...		简介:Mr. I Don&#39;t Care其实也有Care的时候。
电影名:借东西的小人阿莉埃蒂	导演: 米林宏昌 Hiromasa Yonebayashi&nbsp;&nbsp;&nbsp;主演: 志田未来 Mirai Shida / 神木...		简介:曾经的那段美好会沉淀为一辈子的记忆。
电影名:岁月神偷	导演: 罗启锐 Alex Law&nbsp;&nbsp;&nbsp;主演: 吴君如 Sandra Ng / 任达华 Simon Yam / 钟绍...		简介:岁月流逝，来日可追。
电影名:杀人回忆	导演: 奉俊昊 Joon-ho Bong&nbsp;&nbsp;&nbsp;主演: 宋康昊 Kang-ho Song / 金相庆 Sang-kyun...		简介:关于连环杀人悬案的集体回忆。
电影名:七武士	导演: 黑泽明 Akira Kurosawa&nbsp;&nbsp;&nbsp;主演: 三船敏郎 Toshirô Mifune / 志村乔 ...		简介:时代悲歌。
电影名:萤火虫之墓	导演: 高畑勋 Isao Takahata&nbsp;&nbsp;&nbsp;主演: 辰己努 / 白石绫乃 / 志乃原良子		简介:幸福是生生不息，却难以触及的远。 
电影名:怪兽电力公司	导演: 彼特·道格特 Pete Docter / 大卫·斯沃曼 David Silverman&nbsp;&nbsp;&nbsp;主演: 约...		简介:不要给它起名字，起了名字就有感情了。
电影名:谍影重重3	导演: 保罗·格林格拉斯 Paul Greengrass&nbsp;&nbsp;&nbsp;主演: 马特·达蒙 Matt Damon / ...		简介:像吃了苏打饼一样干脆的电影。
电影名:喜宴	导演: 李安 Ang Lee&nbsp;&nbsp;&nbsp;主演: 赵文瑄 Winston Chao / 郎雄 Sihung Lung / 归亚...		简介:中国家庭的喜怒哀乐忍。
电影名:小森林 冬春篇	导演: 森淳一 Junichi Mori&nbsp;&nbsp;&nbsp;主演: 桥本爱 Ai Hashimoto / 三浦贵大 Takahir...		简介:尊敬他人，尊敬你生活的这片土地，明白孤独是人生的常态。
电影名:贫民窟的百万富翁	导演: 丹尼·鲍尔 Danny Boyle / 洛芙琳·坦丹 Loveleen Tandan&nbsp;&nbsp;&nbsp;主演: 戴夫...		简介:上帝之城+猜火车+阿甘正传+开心辞典=山寨富翁
电影名:电锯惊魂	导演: 詹姆斯·温 James Wan&nbsp;&nbsp;&nbsp;主演: 雷·沃纳尔 Leigh Whannell / 加利·艾...		简介:真相就在眼前。
电影名:东邪西毒	导演: 王家卫 Kar Wai Wong&nbsp;&nbsp;&nbsp;主演: 张国荣 Leslie Cheung / 林青霞 Brigitte...		简介:电影诗。
电影名:请以你的名字呼唤我	导演: 卢卡·圭达尼诺 Luca Guadagnino&nbsp;&nbsp;&nbsp;主演: 蒂莫西·柴勒梅德 Timothée ...		简介:沉醉在电影的情感和视听氛围中无法自拔。
电影名:记忆碎片	导演: 克里斯托弗·诺兰 Christopher Nolan&nbsp;&nbsp;&nbsp;主演: 盖·皮尔斯 Guy Pearce /...		简介:一个针管引发的血案。
电影名:真爱至上	导演: 理查德·柯蒂斯 Richard Curtis&nbsp;&nbsp;&nbsp;主演: 休·格兰特 Hugh Grant / 柯林...		简介:爱，是个动词。
电影名:黑天鹅	导演: 达伦·阿罗诺夫斯基 Darren Aronofsky&nbsp;&nbsp;&nbsp;主演: 娜塔莉·波特曼 Natalie...		简介:黑暗之美。
电影名:疯狂原始人	导演: 科克·德·米科 Kirk De Micco / 克里斯·桑德斯 Chris Sanders&nbsp;&nbsp;&nbsp;主演...		简介:老少皆宜，这就是好莱坞动画的魅力。
电影名:哈利·波特与死亡圣器(下)	导演: 大卫·叶茨 David Yates&nbsp;&nbsp;&nbsp;主演: 丹尼尔·雷德克里夫 Daniel Radcliffe...		简介:10年的完美句点。
电影名:萤火之森	导演: 大森贵弘 Takahiro Omori&nbsp;&nbsp;&nbsp;主演: 佐仓绫音 Ayane Sakura / 内山昂辉 K...		简介:触不到的恋人。
电影名:7号房的礼物	导演: 李焕庆 Hwan-kyeong Lee&nbsp;&nbsp;&nbsp;主演: 柳承龙 Seung-yong Ryoo / 朴信惠 Shi...		简介:《我是山姆》的《美丽人生》。
电影名:雨人	导演: 巴瑞·莱文森 Barry Levinson&nbsp;&nbsp;&nbsp;主演: 达斯汀·霍夫曼 Dustin Hoffman ...		简介:生活在自己的世界里，也可以让周围的人显得可笑和渺小。
电影名:英雄本色	导演: 吴宇森 John Woo&nbsp;&nbsp;&nbsp;主演: 周润发 Yun-Fat Chow / 狄龙 Lung Ti / 张国...		简介:英雄泪短，兄弟情长。 
电影名:卢旺达饭店	导演: 特瑞·乔治 Terry George&nbsp;&nbsp;&nbsp;主演: 唐·钱德尔 Don Cheadle / 苏菲·奥...		简介:当这个世界闭上双眼，他却敞开了怀抱。
电影名:海洋	导演: 雅克·贝汉 Jacques Perrin / 雅克·克鲁奥德 Jacques Cluzaud&nbsp;&nbsp;&nbsp;主演:...		简介:大海啊，不全是水。
电影名:心迷宫	导演: 忻钰坤 Yukun Xin&nbsp;&nbsp;&nbsp;主演: 霍卫民 Weimin Huo / 王笑天 Xiaotian Wang ...		简介:荒诞讽刺，千奇百巧，抽丝剥茧，百转千回。
电影名:超能陆战队	导演: 唐·霍尔 Don Hall / 克里斯·威廉姆斯 Chris Williams&nbsp;&nbsp;&nbsp;主演: 斯科特...		简介:Balalala~~~
电影名:唐伯虎点秋香	导演: 李力持 Lik-Chi Lee&nbsp;&nbsp;&nbsp;主演: 周星驰 Stephen Chow / 巩俐 Li Gong / 陈...		简介:华太师是黄霑，吴镇宇四大才子之一。
电影名:蝙蝠侠：黑暗骑士崛起	导演: 克里斯托弗·诺兰 Christopher Nolan&nbsp;&nbsp;&nbsp;主演: 克里斯蒂安·贝尔 Christ...		简介:诺兰就是保证。
电影名:荒蛮故事	导演: 达米安·斯兹弗隆 Damián Szifron&nbsp;&nbsp;&nbsp;主演: 达里奥·葛兰帝内提 Darío...		简介:始于荒诞，止于更荒诞。
电影名:傲慢与偏见	导演: 乔·怀特 Joe Wright&nbsp;&nbsp;&nbsp;主演: 凯拉·奈特莉 Keira Knightley / 马修·...		简介:爱是摈弃傲慢与偏见之后的曙光。
电影名:海边的曼彻斯特	导演: 肯尼斯·罗纳根 Kenneth Lonergan&nbsp;&nbsp;&nbsp;主演: 卡西·阿弗莱克 Casey Affle...		简介:我们都有权利不与自己的过去和解。
电影名:虎口脱险	导演: 杰拉尔·乌里 Gérard Oury&nbsp;&nbsp;&nbsp;主演: 路易·德·菲耐斯 Louis de Funès...		简介:永远看不腻的喜剧。
电影名:纵横四海	导演: 吴宇森 John Woo&nbsp;&nbsp;&nbsp;主演: 周润发 Yun-Fat Chow / 张国荣 Leslie Cheung...		简介:香港浪漫主义警匪动作片的巅峰之作。
电影名:燃情岁月	导演: 爱德华·兹威克 Edward Zwick&nbsp;&nbsp;&nbsp;主演: 安东尼·霍普金斯 Anthony Hopki...		简介:传奇，不是每个人都可以拥有。
电影名:教父3	导演: 弗朗西斯·福特·科波拉 Francis Ford Coppola&nbsp;&nbsp;&nbsp;主演: 阿尔·帕西诺 A...		简介:任何信念的力量，都无法改变命运。
电影名:时空恋旅人	导演: 理查德·柯蒂斯 Richard Curtis&nbsp;&nbsp;&nbsp;主演: 多姆纳尔·格利森 Domhnall Gl...		简介:把每天当作最后一天般珍惜度过，积极拥抱生活，就是幸福。
电影名:玩具总动员3	导演: 李·昂克里奇 Lee Unkrich&nbsp;&nbsp;&nbsp;主演: 汤姆·汉克斯 Tom Hanks / 蒂姆·艾...		简介:跨度十五年的欢乐与泪水。
电影名:花样年华	导演: 王家卫 Kar Wai Wong&nbsp;&nbsp;&nbsp;主演: 梁朝伟 Tony Leung Chiu Wai / 张曼玉 Ma...		简介:偷情本没有这样美。
电影名:完美的世界	导演: 克林特·伊斯特伍德 Clint Eastwood&nbsp;&nbsp;&nbsp;主演: 凯文·科斯特纳 Kevin Cos...		简介:坏人的好总是比好人的好来得更感人。
电影名:恋恋笔记本	导演: 尼克·卡索维茨 Nick Cassavetes&nbsp;&nbsp;&nbsp;主演: 瑞恩·高斯林 Ryan Gosling /...		简介:爱情没有那么多借口，如果不能圆满，只能说明爱的不够。 
电影名:无人知晓	导演: 是枝裕和 Hirokazu Koreeda&nbsp;&nbsp;&nbsp;主演: 柳乐优弥 Yûya Yagira / 北浦爱...		简介:我的平常生活就是他人的幸福。
电影名:达拉斯买家俱乐部	导演: 让-马克·瓦雷 Jean-Marc Vallée&nbsp;&nbsp;&nbsp;主演: 马修·麦康纳 Matthew McCon...		简介:Jared Leto的腿比女人还美！
电影名:二十二	导演: 郭柯 Ke Guo&nbsp;&nbsp;&nbsp;主演: 		简介:有一些东西不应该被遗忘。
电影名:雨中曲	导演: Stanley Donen / Gene Kelly&nbsp;&nbsp;&nbsp;主演: Gene Kelly / Donald O'Connor / ...		简介:骨灰级歌舞片。
电影名:魂断蓝桥	导演: Mervyn LeRoy&nbsp;&nbsp;&nbsp;主演: Vivien Leigh / Robert Taylor / Lucile Watson		简介:中国式内在的美国电影。
电影名:猜火车	导演: 丹尼·博伊尔 Danny Boyle&nbsp;&nbsp;&nbsp;主演: 伊万·麦克格雷格 Ewan McGregor / ...		简介:不可猜的青春迷笛。 
电影名:血战钢锯岭	导演: 梅尔·吉布森 Mel Gibson&nbsp;&nbsp;&nbsp;主演: 安德鲁·加菲尔德 Andrew Garfield /...		简介:优秀的战争片不会美化战场，不会粉饰死亡，不会矮化敌人，不会无视常识，最重要的，不会宣扬战争。
电影名:穿越时空的少女	导演: 细田守 Mamoru Hosoda&nbsp;&nbsp;&nbsp;主演: 仲里依纱 Riisa Naka / 石田卓也 Takuya...		简介:爱上未来的你。 
电影名:我是山姆	导演: 杰茜·尼尔森 Jessie Nelson&nbsp;&nbsp;&nbsp;主演: Sean Penn / Dakota Fanning / Mi...		简介:爱并不需要智商 。
电影名:冰川时代	导演: 卡洛斯·沙尔丹哈 Carlos Saldanha / 克里斯·韦奇 Chris Wedge&nbsp;&nbsp;&nbsp;主演...		简介:松鼠才是角儿。
电影名:人工智能	导演: 史蒂文·斯皮尔伯格 Steven Spielberg&nbsp;&nbsp;&nbsp;主演: 海利·乔·奥斯蒙 Haley...		简介:对爱的执着，可以超越一切。
电影名:爆裂鼓手	导演: 达米安·沙泽勒 Damien Chazelle&nbsp;&nbsp;&nbsp;主演: 迈尔斯·特勒 Miles Teller /...		简介:这个世界从不善待努力的人，努力了也不一定会成功，但是知道自己在努力，就是活下去的动力。
电影名:浪潮	导演: 丹尼斯·甘塞尔 Dennis Gansel&nbsp;&nbsp;&nbsp;主演: 尤尔根·沃格尔 Jürgen Vogel ...		简介:世界离独裁只有五天。
电影名:未麻的部屋	导演: 今敏 Satoshi Kon&nbsp;&nbsp;&nbsp;主演: 岩男润子 Junko Iwao / 松本梨香 Rica Matsu...		简介:好的剧本是，就算你猜到了结局也猜不到全部。
电影名:罗生门	导演: 黑泽明 Akira Kurosawa&nbsp;&nbsp;&nbsp;主演: 三船敏郎 Toshirô Mifune / 千秋实 ...		简介:人生的N种可能性。
电影名:朗读者	导演: 史蒂芬·戴德利 Stephen Daldry&nbsp;&nbsp;&nbsp;主演: 凯特·温丝莱特 Kate Winslet ...		简介:当爱情跨越年龄的界限，它似乎能变得更久远一点，成为一种责任，一种水到渠成的相濡以沫。 
